NO ./textures/wall.png
SO ./textures/wall.png
WE ./textures/wall.png
EA ./textures/wall.png

F 22...0,100,0
C 100,150,255


     11111
     100N1
     11111