NO ./textures/wall.png
SO ./textures/wall.png
WE ./textures/wall.png
EA ./textures/wall.png

F 50,50,50
C 100,150,255


1111111111111
1000100000001
10W0000100001
1000000000001
1000000000001
1000000000001
1000000000001
1000000000001
1000000000001
1111111111111