NO ./textures/wall.png
SO ./textures/wall.png
WE ./textures/wall.png
EA ./textures/wall.png




     1111
     10N1
     1111
      
F 220,100,0
C 100,150,255